11111111
11011011
10000001
10000001
11011011
11111111

