11111111
10000011
12200001
10000221
11000001
11111111
