11111111
10000001
12200001
10000221
10000001
11111111
